yjd: oxd gnm sct
bgc: pho cpg gru jnr
vdl: mgp cxx vpj
upf: cbw cxx vpj
huo: cdh vmx
cvj: pia pxm
bcu: lwn bbq suo
sce: out
pds: cbw cxx vpj
ako: ash maj fnq
kxg: zgp clk
fsx: yir bgn
nle: aiw gwo oah
flq: out
gbw: tgz
nop: gpq
wwe: ddh hsr zbw lgg
qtj: jpl
xsm: vpj mgp
wkg: cyt jpb iml
igy: fxe pit kue
iml: cfx udp bbq suo
kle: dev nhy kxb
ouf: sgm rql odr
dki: yma tdp
avt: lwn suo
mak: cye bag
ocd: vkj
bag: bma kks iud
wwm: hyx ndf gbo tbn goo xep kzj iyo egq css lka idi tun eya
yke: zaq khl you
qmz: dev
abi: mzr hnl rru
rxd: you zaq khl
njg: ydx igy zyy gev ogm unh ehf zsc hey jhf wbl tzt
qdf: vpj mgp
lxb: huo sda ojq
rja: tpj cgm
pob: txa bpj
pav: dtf kba dwh lxb scc
hey: gdf ime
ahi: eya tun lmu tbn css egq mje iyo jby xep
fbu: pob yin
qlx: mzt nro dyq
oad: txa wcn ufs
nuw: cdh orm
vel: npu vas
gvs: amy ynd eqc
dpu: vpj mgp cbw
hgt: ccs gzk tkq vvg
krw: upf
kml: pxm pia sct gnm
ssu: dac wrv
nwh: lwn udp bbq suo
mzt: out
bjb: tla wip
jpl: lwn cfx udp bbq suo
czc: gnm sct pxm
pyk: ufv cmw ufr uxj
gmc: tkg hqx
xza: cfx
adr: knh mak cmf
vax: ngx fjh stx
gdv: jpl yky nkh
ojq: cdh orm
vja: ioo bgc
tti: cvj
blw: njg orm vmx
kue: xza ifa efu qdy
tto: mmo dac
raz: vbb tcx ukx zpz
akk: nle tef
dac: ljy sif rxd
clk: lme ivb
qyx: eai fft
tgd: cxx mgp
ngx: khl
kcd: cbw
hqj: trc fiz
qqh: mid tpj
sps: cdh njg orm
roo: pia pxm sct oxd gnm
wqz: nle
ahw: nhy kxb
jwi: sjz ysu ikc
gmk: ywt gpq
aox: orm cdh vmx
hlj: iti
pxo: stx uok
vkj: jwk jiu
hsr: quo ncp fsx rqf
evw: zaq
bpj: uhu spk
vas: jiu
dev: ydr
cyt: suo cfx
txa: uhu
pia: znv xmd ako fig ssu
svr: iaw vyf ahi euv wwm
ddh: fsx ncp zhp
uge: cmw uxj ufr
lhz: uuu fll
wcn: uhu urq
yhd: iml cyt jpb
epy: czi djw
suo: wjb uhq qmz lhz kle liy pfb adr eep fue ugi qhd rye vvm vdx gui ahw
spk: qyn
tke: kdb fdo
hqx: aox fwg nuw
scc: ojq blw sda
ssx: njg orm cdh vmx
zhp: yir bgn
tcr: ydr
bgn: bnd gux
kks: sct
igq: uoo qyh euu
umc: suo bbq lwn cfx
iok: vmx njg
cfx: vdx qmz wjb ugi pfb kle
pxm: eao tto ort dut aea krd
ysu: swc
efu: bbq suo udp cfx
qzy: kcd vdl xsm
odr: qtj gdv
cpg: out
upt: pob udv yin
cmw: ocd vel
fft: vhg kvl
our: cfx udp suo bbq
uhq: nhy tcr
gci: vmx cdh orm njg
iyo: hkh idw krw
iaw: lka idi ylv tun iyo egq css uge pyk hyx ndf mje rzv lmu
fpa: cbw cxx mgp vpj
gwy: mkv cwh hxy szg
ngt: uao
fjh: khl you
ifv: oad pob udv ceu
zsc: vji pkx yhd
xtl: you khl
pqc: znm cvj
fwg: vmx cdh njg
qhv: flq
ncp: yir wmy bgn
gwh: hld vbb zpz ukx tcx
rfo: kce rru
epz: vas
ejh: pia pxm sct
rye: frm qtv mek
mst: ugr nle
bbq: adr vdx pfb qmz qhd
xkd: out
muz: zgp bkc
ufr: vel vcs fjj epz
tcx: umc
mzr: iyp
ryv: fir bwy skm qzv
vxm: dnu qyx
hvm: sct pxm pia
euv: css uge iyo jby xep hyx ylv pyk tun
ihm: vmx
jhf: fdo ouf kdb
dyq: out
yir: bnd qlw
unh: pom
wvy: you zaq
cbw: byt ljk fmy yla jer lbf bcd gmc zua rvq afv sur wpy pgt kxf
jby: epk hjx
jvq: cba pav
eao: vwn hgt
ydr: roo yjd pne egz
tfo: fxe
urq: qlx
yin: txa ufs yoq bpj
mek: vpy tol rfo
vmx: lhd hey tfo igy bkn ogm sjm ydx
exo: cdh vmx njg orm
iyn: qdy
qyh: hkp oiv
yia: tcx vbb
twr: egz yjd jxn roo
tbn: djn jwi jkt
xkq: cdh njg orm
tkq: zaq
asc: cbw mgp cxx vpj
tun: cmw uxj ufv
sct: xsx fig xmd aea sso loq ako gsn eao fkm ssu nvk cpx tga gwy ort dut znv krd
iyp: oxd gnm pxm pia
yoq: spk uhu urq
ksa: dba ick uyj
byt: gvs dff loi ngt
vhg: cow bis
afv: ekg orp tzd
mfg: zaq
mcu: cdh vmx
ivb: ugr tef
goo: djn xxq
cgm: ffh vyt odi
qdy: cfx bbq suo udp
ipn: vpj cbw
uao: hyd xkq iok
ams: cas
mhb: bcu
swc: bwy skm qzv
hyx: epk nxf uwr
eep: qtv mek sfu
jqi: khl
qyn: nro dyq
vvg: zaq you
wbl: kue
fiz: tdp byk
tkg: aox pdc
pgt: ruw hqx tkg
gzk: zaq you
css: hjx epk nxf mwu
nkh: bbq suo lwn
uoo: hkp
ass: cow bis
gdf: bcu our avt rxm
xep: yzo tiw eeg syu
ccs: zaq khl you
tga: szg hxy git
oju: ngt loi dff uyu gvs
qdv: myx ywt
ulg: epy fkt cas fot
bis: njg
lwn: pfb gui ahw kle igq vdx lhz qhd wjb ugi
dnu: fft eai dau
nvk: hgt vwn
tla: ddh hsr lgg
hxy: yke zhn xtl evw jqi
cas: ahr czi djw qhv kae
myd: mcu
kvl: zal
uwr: ipn
kce: jvr iyp grs
gda: upf gqt
ufs: uhu
khl: ouk upt ols fbu ifv gmk qdv bjb oac
oxd: loq tto xsx sso
jpw: hvm czc sau
vwn: vvg ccs mfg
aea: awe tns
eya: cmw ufv
bnd: out
sls: dtf scc lxb dwh
kfz: mgp
aiw: njv pbq
npu: jwk qdf
mic: tla
cow: vmx orm
oyj: gwh
trc: yma jgt
bex: tkq ccs mfg
wmy: qlw bnd
ysh: mgp cxx cbw
rxm: cfx udp suo
iti: cbw vpj
mmo: ljy rcf
dff: eqc
kae: fvk jlm
eai: ass kvl
jvm: raz yia
lbf: bhl htl myd
sif: khl
mid: odi vyt ffh
lka: ksa
gbo: tiw qzy eeg syu
jwk: cxx
ysf: gqt
egz: pxm gnm
ydx: jvm oyj pom
veb: cfx lwn bbq
tol: kce moa mzr
znm: oxd gnm sct
mje: uwr epk nxf
sur: dnu
wpy: htl bhl
nll: dnu rux
vyq: skm ysh fir qzv
sjm: ouf kdb
qtv: tol
dau: kvl
ikc: ryv swc oxs
bkn: iyn fxe pit kue
xvu: ngx uok
jkt: sjz zkq zwq
oah: pbq mit njv sce
grs: pxm sct oxd gnm
eqz: bcu our avt rxm
gpq: ulg
anf: qvp erd tti
stx: khl zaq you
vji: veb iml
yma: ezz
ylv: aeq ksa
krd: vwn
gwo: mit sce
tiw: xsm ctw
ime: our bcu rxm
dad: myd htl
ehf: kue iyn
uhu: qlx upo
pit: xza ifa efu
bma: pia pxm gnm oxd
cxx: dad afv pgt sur sfd kxf yla oju lbf ljk gmc zua rvq
yky: bbq cfx
bwy: cbw mgp
frm: rfo abi tol vpy
ezz: you khl zaq
myx: bmo
yla: jvq tzd
ljk: htl bhl
czi: xkd flq jlm
erd: kml znm
szg: yke jqi evw xtl
udv: txa wcn ufs
uuu: eul jpw otq
log: egz pne jxn yjd
tbi: tla wwe wip
rux: eai fft
bkc: lme wqz akk
orp: sls pav
ruw: nuw aox jgo pdc
fvk: out
slp: dac wrv mmo
wuy: bkc clk
ugr: gwo oah
epk: jty pds kfz fpa
dtf: ojq blw ihm
ouk: ceu udv oad
yex: otq
lhd: yhd pkx gyz wkg
via: hlj ick dba
zbw: rqf quo
pom: raz gwh yia
zbu: pxm sct
zgp: lme ivb wqz mst
ffh: zkn koj
gnm: cpx nvk ssu fkm eao znv dut ort tga gwy sso slp aea xmd fig xsx tto gsn ako loq
loq: fnq ash
gqt: mgp vpj
ahr: flq jlm fvk
nce: byk yma jgt
bqv: sct gnm pxm pia
byk: zmf ezz
nxf: fpa kfz ipn pds
maj: pxo
sfd: rux
dut: dac wrv
kxf: ekg tzd jvq
rvq: loi
eot: bbq suo udp cfx
xsc: ngx uok fjh
ukx: nwh eot umc
mit: out
ick: rrz tgd
njv: out
koj: czp uhr bgc ioo
orm: igy bkn ydx ceg lhd ozn ogm hvr wbl tke jhf hey tfo unh
oxs: ysh bwy fir qzv
cbk: anf
sau: pxm oxd
jer: myd
kzj: ksa aeq
ywt: ulg ams bmo
pho: out
jxn: sct oxd gnm pia pxm
hvr: pom blv
ozn: wkg vji
ceg: mhb
sda: njg orm vmx cdh
ugi: fll uuu yex
ash: vax pxo xsc
fnq: xsc xvu ewz
awe: dki trc
zpz: agt nwh dcv eot
dlg: out
jlm: out
zkn: ioo bgc
skm: vpj
dwh: blw ihm sda
upo: dlg mzt
czp: pho gru lsg cpg
fmy: hqx ruw
znv: bex hgt
gui: cbk uoo
ifa: cfx lwn suo udp
yzo: kcd pzo
zkq: vyq
cpx: bex vwn
sjz: oxs
zyy: mhb gdf ime
euu: oiv anf hkp
lme: tef
pne: pia
gsn: wrv mmo dac
eul: bqv sau hvm
fdo: sgm gbw odr
hnl: xuk iyp grs
rqf: yir
fxe: efu
git: zhn
lmu: gda krw ysf idw hkh
tef: krs aiw
djw: fvk jlm xkd
sir: sct gnm oxd
zpn: out
fkm: maj ash
tns: trc dki
rru: sir grs iyp
oac: mid
jnr: out
dba: rrz xeu iti tgd
nro: out
syu: ctw xsm pzo vdl
bmo: epy
jgt: ezz wvy
nhy: twr
ioo: pho
qhd: fll yex uuu
ynd: xkq exo iok gci
uyj: tgd dpu iti rrz
bhl: ssx mcu sps
sgm: qtj tgz gdv
rkk: cye
kbm: exo
zal: orm njg cdh vmx
ufv: vel vcs fjj
jty: cbw mgp
pbq: out
tzd: cba
loi: ynd kbm amy eqc
you: nfz fnc bjb oac tbi mic nop qdv fbu ifv wuy ouk kxg
fue: qtv sfu frm
krs: pbq zpn njv sce
eeg: pzo ctw
ogm: mhb eqz
djn: ysu ikc zwq sjz
bcd: ekg orp jvq
tdp: wvy zmf
idi: ysf gda
agt: suo bbq lwn
dcv: bbq cfx
ctw: cxx mgp cbw
jpb: bbq udp cfx lwn
tzt: pom jvm
uxj: epz vel
mwu: fpa ipn pds jty
vdx: uoo euu
tpj: ffh vyt odi
moa: sir jvr xuk grs
sfu: abi rfo
pzo: vpj cxx cbw
ceu: ufs yoq
gux: out
jgo: njg cdh vmx
vpy: hnl mzr
iud: pxm pia gnm
eqc: xkq gci iok exo
vpj: kxf sfd wpy sur pgt afv rvq zua gmc lbf oju jer nll yla dad ljk
gru: out
odi: koj vja
xuk: oxd gnm
lgg: quo ncp rqf
vyt: vja
pdc: njg cdh vmx
hld: agt eot
cdh: zyy lhd ydx igy tfo ehf unh zsc wbl tke jhf gev hvr ozn ogm
qzv: mgp cxx
zhn: khl
idw: gqt
hjx: fpa pds jty
xmd: tns oua awe
jiu: cxx mgp vpj cbw
lsg: out
wmo: bma zbu iud
ewz: uok
zwq: oxs vyq bff
blv: raz gwh
kdb: rql odr sgm
quo: wmy bgn yir
zaq: rja wuy nfz qqh muz kxg fnc tbi oac fbu
uok: khl
oiv: pqc qvp erd
gev: mhb
fot: qhv czi djw ahr
cwh: yke jqi
rql: tgz gdv
wip: lgg zbw
vcs: vkj vas
qvp: znm
oua: nce
liy: rkk knh cmf mak
udp: ahw gui vdx vvm rye eep fue ugi qhd liy pfb kle lhz igq qmz uhq wjb
knh: cye bag
rzv: via ksa
xsx: hqj
cye: iud zbu
otq: bqv ejh czc sau
htl: sps ssx
wrv: rxd rcf sif ljy
cmf: wmo cye
gyz: veb cyt jpb
jvr: pia pxm
bff: ysh skm fir qzv
rcf: zaq khl you
qlw: out
cba: dtf kba dwh scc
kba: ihm sda huo blw
kxb: log ydr twr
xxq: ikc ysu sjz zkq
aeq: hlj uyj dba
mkv: evw xtl
ort: mkv szg hxy
vyf: lka egq tbn rzv eya
ekg: sls pav
vbb: umc nwh dcv agt
ndf: syu eeg yzo
zua: dnu qyx
pfb: euu uoo
uhr: lsg cpg gru
fll: eul jpw
fjj: vkj vas
hyd: cdh njg orm
xeu: cbw vpj mgp
zmf: you
mgp: fmy dad oju jer nll vxm sfd sur pgt kxf lbf zua
ljy: you khl
rrz: mgp
nfz: wwe wip
hkp: qvp erd pqc
sso: git
fnc: mid cgm
fkt: ahr djw czi kae
hkh: upf asc
ols: ywt myx
tgz: nkh
wjb: uoo cbk
pkx: veb cyt jpb
fir: cbw
vvm: rkk knh cmf mak
fig: tns
uyu: eqc uao amy kbm
amy: gci xkq hyd
egq: jwi
